1111111111111111111111111111111111
1E1000000000000C00000C000000000001
1010010100100000101001000000010101
1010010010101010001001000000010101
1011111000000000000000000000000001
1010001000000000000000000000000001
1010C00000000000000000000P00000001
1010001000000000000000000000000001
1011111000000000000000000000000001
100000000C00C0000000000000000000C1
1111111111111111111111111111111111