1111111111111111111111111111111111111111111111111111111111111111111111111111111111111111111111111111
1111111111100000000000000000000000000000000000000000000000000000000000000000000000000000011111111111
111111111110111111100000000111111111111111C000000011111111111111100000000000000001111111011111111111
1111111111101111111011111111111111011111110111111111111110111111101111111111111101111111011111111111
1111111111101111111011111111111111011111110111111111111110111111101111111111111101111111011111111111
11111111111011111110111111100C0000001111110111111100000000000000001111111111111101111111011111111111
1111111111100000000111111111111111100000000000000000000000111111100000000111111110000000011111111111
1111111111101111111111111111111111111111111111111111111110111111101111111111111111111111011111111111
1111111111101111111111111111111111111111111111111111111110111111101111111111111111111111011111111111
1111111111101111111011111111111111011111111111111111111110111111111111111111111111111111011111111111
1111111111101111111011111110000000011111110111111111111110000000001111111111111100000000011111111111
1111111111101111111011111111111111111111110111111111111110111111101111111111111111111111011111111111
1111111111101111111011111111111111111111110111111111111110111111101111111011111111111111011111111111
1111111111101111111011111110000000000000000000000000000000111111111111111000000001111111011111111111
1111111111101111111011111111111111011111111111111111111111111111111111111111111101111111011111111111
1111111111101111111000000001111111000000000000000000000000000000000000000000000001111111011111111111
1111111111100000000011111100000000E11111110111111100000000000000001111111111111100000000011111111111
1111111111101111111111111111111111011111111111111111111111111111101111111111111111111111011111111111
1111111111101111111111111111111111011111111111111111111111111111101111111111111111111111011111111111
1111111111101111111111111111111111011111111111111011111111111111101111111011111111111111011111111111
1111111111101111111000000000000000000000000000000011111110111111111111111000000001111111011111111111
1111111111101111111111111111111111111111111111111111111110111111111111111111111111111111011111111111
1111111111100000000000000000000000000000000000000000000000P00000000000000000000000000000011111111111
1111111111111111111111111111111111111111111111111111111111111111111111111111111111111111111111111111
1111111111111111111111111111111111111111111111111111111111111111111111111111111111111111111111111111